//MAP CONVERTED BY dmm2tgm.py THIS HEADER COMMENT PREVENTS RECONVERSION, DO NOT REMOVE
"a" = (
/obj/effect/spawner/lootdrop/f13/common,
/turf/template_noop,
/area/f13/wasteland)
"c" = (
/turf/template_noop,
/area/f13/wasteland)
"d" = (
/obj/structure/destructible/tribal_torch/lit,
/turf/template_noop,
/area/f13/wasteland)
"h" = (
/obj/effect/spawner/lootdrop/f13/common_guns,
/obj/effect/spawner/lootdrop/f13/common_mags,
/obj/effect/spawner/lootdrop/f13/common,
/obj/effect/spawner/lootdrop/f13/common,
/obj/effect/spawner/lootdrop/f13/common,
/obj/effect/spawner/lootdrop/f13/uncommon,
/obj/effect/spawner/lootdrop/f13/uncommon_food,
/turf/template_noop,
/area/f13/wasteland)
"n" = (
/obj/structure/nest/gecko/tribal,
/turf/template_noop,
/area/f13/wasteland)
"q" = (
/obj/effect/spawner/lootdrop/f13/common_guns,
/obj/effect/spawner/lootdrop/f13/common_mags,
/obj/effect/spawner/lootdrop/f13/common,
/obj/effect/spawner/lootdrop/f13/common,
/obj/effect/spawner/lootdrop/f13/common,
/obj/effect/spawner/lootdrop/f13/uncommon,
/obj/effect/spawner/lootdrop/f13/common_mats,
/turf/template_noop,
/area/f13/wasteland)
"r" = (
/obj/structure/nest/gecko/tribal/guard,
/turf/template_noop,
/area/f13/wasteland)
"w" = (
/obj/structure/barricade/wooden,
/turf/template_noop,
/area/f13/wasteland)
"C" = (
/obj/effect/spawner/lootdrop/f13/common_mats,
/obj/effect/spawner/lootdrop/f13/common,
/obj/effect/spawner/lootdrop/f13/common,
/obj/effect/spawner/lootdrop/f13/common,
/obj/effect/spawner/lootdrop/f13/uncommon,
/obj/effect/spawner/lootdrop/f13/uncommon_food,
/turf/template_noop,
/area/f13/wasteland)
"E" = (
/obj/structure/nest/gecko,
/turf/template_noop,
/area/f13/wasteland)
"Q" = (
/obj/effect/spawner/lootdrop/f13/common_guns,
/obj/effect/spawner/lootdrop/f13/common_mags,
/obj/effect/spawner/lootdrop/f13/common,
/obj/effect/spawner/lootdrop/f13/common,
/obj/effect/spawner/lootdrop/f13/common,
/obj/effect/spawner/lootdrop/f13/uncommon,
/obj/effect/spawner/lootdrop/f13/uncommon_mats,
/turf/template_noop,
/area/f13/wasteland)
"W" = (
/mob/living/simple_animal/hostile/gecko/tribal/hunter,
/turf/template_noop,
/area/f13/wasteland)

(1,1,1) = {"
a
c
c
c
c
c
c
c
c
c
"}
(2,1,1) = {"
c
c
W
c
r
c
a
c
E
c
"}
(3,1,1) = {"
c
c
d
c
c
c
c
d
c
c
"}
(4,1,1) = {"
E
c
c
w
w
w
w
c
c
a
"}
(5,1,1) = {"
c
c
c
w
Q
C
w
c
c
c
"}
(6,1,1) = {"
c
a
c
w
q
h
w
c
c
c
"}
(7,1,1) = {"
c
c
c
w
w
w
w
c
c
n
"}
(8,1,1) = {"
c
c
d
c
c
a
c
d
c
c
"}
(9,1,1) = {"
a
r
c
c
W
c
E
c
c
a
"}
(10,1,1) = {"
c
c
c
a
c
c
c
c
c
c
"}
