//MAP CONVERTED BY dmm2tgm.py THIS HEADER COMMENT PREVENTS RECONVERSION, DO NOT REMOVE
"a" = (
/turf/template_noop,
/area/f13/wasteland)
"e" = (
/mob/living/simple_animal/hostile/gecko/tribal/hunter,
/turf/template_noop,
/area/f13/wasteland)
"g" = (
/obj/structure/nest/gecko/tribal,
/turf/template_noop,
/area/f13/wasteland)
"o" = (
/obj/effect/spawner/lootdrop/f13/common,
/turf/template_noop,
/area/f13/wasteland)
"r" = (
/obj/structure/barricade/wooden,
/turf/template_noop,
/area/f13/wasteland)
"t" = (
/obj/effect/spawner/lootdrop/f13/common_guns,
/obj/effect/spawner/lootdrop/f13/common_mags,
/obj/effect/spawner/lootdrop/f13/common,
/obj/effect/spawner/lootdrop/f13/common,
/obj/effect/spawner/lootdrop/f13/common,
/obj/effect/spawner/lootdrop/f13/uncommon,
/obj/effect/spawner/lootdrop/f13/uncommon_food,
/turf/template_noop,
/area/f13/wasteland)
"z" = (
/obj/structure/nest/gecko/tribal/guard,
/turf/template_noop,
/area/f13/wasteland)
"B" = (
/obj/effect/spawner/lootdrop/f13/common_mats,
/obj/effect/spawner/lootdrop/f13/common,
/obj/effect/spawner/lootdrop/f13/common,
/obj/effect/spawner/lootdrop/f13/common,
/obj/effect/spawner/lootdrop/f13/uncommon,
/obj/effect/spawner/lootdrop/f13/uncommon_food,
/turf/template_noop,
/area/f13/wasteland)
"N" = (
/obj/structure/destructible/tribal_torch/lit,
/turf/template_noop,
/area/f13/wasteland)
"O" = (
/obj/structure/nest/gecko,
/turf/template_noop,
/area/f13/wasteland)
"P" = (
/obj/effect/spawner/lootdrop/f13/common_guns,
/obj/effect/spawner/lootdrop/f13/common_mags,
/obj/effect/spawner/lootdrop/f13/common,
/obj/effect/spawner/lootdrop/f13/common,
/obj/effect/spawner/lootdrop/f13/common,
/obj/effect/spawner/lootdrop/f13/uncommon,
/obj/effect/spawner/lootdrop/f13/common_mats,
/turf/template_noop,
/area/f13/wasteland)
"Z" = (
/obj/effect/spawner/lootdrop/f13/common_guns,
/obj/effect/spawner/lootdrop/f13/common_mags,
/obj/effect/spawner/lootdrop/f13/common,
/obj/effect/spawner/lootdrop/f13/common,
/obj/effect/spawner/lootdrop/f13/common,
/obj/effect/spawner/lootdrop/f13/uncommon,
/obj/effect/spawner/lootdrop/f13/uncommon_mats,
/turf/template_noop,
/area/f13/wasteland)

(1,1,1) = {"
o
a
a
a
a
a
a
a
a
a
"}
(2,1,1) = {"
a
a
e
a
z
a
o
a
O
a
"}
(3,1,1) = {"
a
a
N
a
a
r
a
N
a
a
"}
(4,1,1) = {"
O
a
a
r
r
r
r
a
a
o
"}
(5,1,1) = {"
a
a
a
r
Z
B
r
r
a
a
"}
(6,1,1) = {"
a
o
r
r
P
t
r
r
a
a
"}
(7,1,1) = {"
a
a
r
r
r
r
r
a
a
g
"}
(8,1,1) = {"
a
a
N
a
r
o
a
N
a
a
"}
(9,1,1) = {"
o
z
a
a
e
a
O
a
a
o
"}
(10,1,1) = {"
a
a
a
o
a
a
a
a
a
a
"}
